42 24
ษออออออออออออออออออออออออออออออออออออออออป
บ                                        บ
บ                       *                บ
บ               *         *              บ
บ                ษอออออออออออออป         บ
บ     *          บ  *****      บ         บ
บ                บ****                   บ
บ                บ  *****      ษป        บ
บ           *    ฬออออ         ศผ        บ
บ                บ* * * * *              บ
บ                บ * * * * *   บ         บ
บ       *        บ  * * * * *  บ         บ
บ                ศอออออออออออออผ *       บ
บ                        *               บ
บ         **                             บ
บ           *                            บ
บ                                  *     บ
บ              *                         บ
บ            *                           บ
บ    *                                   บ
บ                   *                *   บ
บ                    *  *                บ
บ                                        บ
ศออออออออออออออออออออออออออออออออออออออออผ
12
10 10 
9 10
8 10
8 9
8 8
8 7
8 6
8 5
8 4
8 3
9 3
19 3
